衣衫襤褸=破破爛爛的
金屬棒=金屬錠
賽場=遊樂場
棒球棍=球棒
團子=糰子
貼士=秘訣
髮卡=髮飾
溜躂=走動
置放=放置
鎮子=城鎮
帶上=帶著
掙錢=賺錢
掙取=賺取
掙到=賺到
掙些=賺些
提高=提升
魚竿=釣竿
沙龍=酒吧
山貨=山產
甜心=寶貝
木頭=木材
攢=存
樂隊=樂團
銅棒=銅錠
鐵棒=鐵錠
金棒=金錠
銥棒=銥錠

虞美人松糕=罌粟籽瑪芬
隧道掘進隊=隧道隊
占卜寫板=通靈板
生魚壽司=卷壽司
祖祖市=祖祖城
煎雞蛋=荷包蛋
甜豌豆=香豌豆
齊先生=Mr. Qi
齊幣=Qi 幣
喬家=Joja
JOJA=Joja
茶几=茶桌
格球=橄球
橄欖球=橄球
凍淚=淚晶
蒜=大蒜
價值提升=售價提升
價值上升=售價提升
價值提高=售價提升
價值增加=售價提升
迴圈生產=循環生產
精工製品=加工品
紅葉捲心菜=紫高麗菜
虛空烈酒=虛空暗影
混合蔬菜=蔬菜雜燴
甘藍=羽衣甘藍
炒蘑菇=炸蘑菇
蟹黃糕=蟹肉餅
八爪魚=章魚
玫瑰仙子=仙女玫瑰
營養快線=蛋白棒
冰凍稀泥=藍色史萊姆
冰凍果凍=藍色史萊姆
冰凍蝙蝠=冰霜蝙蝠
沙塵惡靈=塵埃精靈
灰塵精靈=塵埃精靈
山洞昆蟲=洞穴昆蟲
骨頭戰士=骷髏戰士
骨頭法師=骷髏法師
骨頭鑰匙=骷髏鑰匙
骨頭山洞=骷髏山洞
石魔=石魔像
野山葵=野辣根
山洞蘿蔔=洞穴胡蘿蔔
洞穴蘿蔔=洞穴胡蘿蔔
山洞胡蘿蔔=洞穴胡蘿蔔
鳳尾魚=鯷魚
金槍魚=鮪魚
大眼魚=玻璃梭吻鱸
鼓眼魚=玻璃梭吻鱸
紅鯔魚=秋姑魚
石魚=石頭魚
綠豆=豌豆
魚肉卷=魚肉塔可餅
爆炒青椒=辣椒鑲起司
椰汁湯=椰奶湯
墨西哥薄餅=玉米薄餅
帕爾瑪乳酪茄子=帕馬森乳酪茄子
大米布丁=米布丁
霜淇淋=冰淇淋
藍莓千層酥=藍莓塔
巨無霸餐=巨無霸特餐
紅莓醬=蔓越莓醬
填料麵包=填料
根菜拼盤=塊根拼盤
塊莖拼盤=塊根拼盤
大麥粉=小麥粉
龍葵=羊肚菌
未碾米=稻穀
水稻芽=秧苗
甜菜根=甜菜
草籽=草種
愛爾淡啤酒=淡艾爾啤酒
矮人語教程=矮人語翻譯指南
矮人語教學=矮人語翻譯指南
能量飲品=能量補劑
蛤=扇貝
香味漿果=辛香漿果
甜豌豆=香豌豆
工作小食=田野零食
大米=米
魚籽醬=魚子醬
魚籽=魚卵
石基=石頭地基
吊墜=墜飾
史萊姆剋星戒指=蠱惑史萊姆戒指
野蠻人戒指=野蠻戒指
結實戒指=堅定戒指
傑明石=三斜砷銅石
鐵鉛礦=氯矽鐵鉛礦
新矽鈣石=新水矽鈣石
貓眼石=蛋白石
赤紅貓眼石=火蛋白石
沙岩=砂岩
泥石=泥岩
陶瓷碎片=星之碎片
史前脊骨=史前椎骨
蔬菜什錦蓋飯=什錦蔬菜蓋飯
脆皮黑莓餡餅=脆皮黑莓派
蔓越莓糖果=蔓越莓果汁
柳丁=柳橙
旋式魚餌=旋式亮片魚鉤
羅非魚=吳郭魚
麻哈脂鯉=黃金河虎
青花魚=長鰭鮪魚
蛇齒單線魚=長蛇齒單線魚
貽貝=淡菜
蚌=淡菜
海鮮雜燴湯=巧達濃湯
楓糖甜甜圈=楓糖板擦甜甜圈
楓糖條=楓糖板擦甜甜圈
楓糖棒=楓糖板擦甜甜圈
蝦雞尾酒=雞尾酒蝦
萬能魚餌=野性魚餌
樹肥=樹木肥料
美洲大樹莓=鮭莓
鮭魚莓=鮭莓
美莓=鮭莓
杏子=杏桃
韭菜=韭蔥
圍欄=柵欄
大門=柵欄門
美乃滋機=美乃滋製造機
蟲餌盒=蟲餌箱
煤炭窯=木炭窯
雨水圖騰=降雨圖騰
木頭火炬=木製火盆
石頭火炬=石製火盆
鏤空火炬=雕刻火盆
火炬=火盆
木牌=木製告示牌
石牌=石製告示牌
三倍即溶咖啡=三倍濃縮咖啡
噴壺=澆水壺
凡吉爾共和國=芬吉爾共和國
蛋蛋節=彩蛋節
復活節=彩蛋節
罐頭瓶=醃製桶
霸王辣椒=霸王椒龍
小龍蝦=螯蝦
蝦=蝦子
浮木=漂流木
完美早餐=早餐套餐
風化地板=陳舊地板
黃金礦石=金礦石
普通蘑菇=蘑菇
大壺牛奶=大瓶牛奶
幸運紫色短褲=幸運紫色內褲
餐吧=酒吧
影子人=暗影人
社區中心=活動中心
社區活動中心=活動中心
圖紙=藍圖
菜譜=食譜
醬料女皇=醬料女王
字條=紙條
便條=紙條
醃製罐=醃製桶
籬笆=柵欄
寶箱=箱子
酒館=酒吧

艾米莉=艾米麗
艾蜜莉=艾米麗
路易士=路易斯
劉易斯=路易斯
鎮長路易斯=路易斯鎮長
瑪尼=瑪妮
薩姆=山姆
蓋斯=格斯
哈威=哈維
亞歷克斯=艾力克斯
艾利歐特=艾略特
潘妮=佩妮
克林特=克林
德米特裡厄斯=迪馬崔斯
德米特里厄斯=迪馬崔斯
艾芙琳=伊芙琳
賈斯=潔絲
科羅布斯=柯洛布斯
皮埃爾=皮耶爾
喬迪=喬蒂
桑迪=沙蒂
文森特=文森
法師=巫師
塞巴斯蒂安=賽巴斯汀
門衛=保鑣
僕從=哥布林手下
雷歐=里歐

▼▼=……
▼=……
?=？
?=？
? =？
!=！
!=！
! =！
(=（
) =）
(=（
)=）

佈=布
銹=鏽
粧=妝
墻=牆
樑=梁

 @=@
@ =@

金制=金製
銀制=銀製
銅制=銅製
鐵制=鐵製
鋼制=鋼製
銥制=銥製
鉛制=鉛製
木制=木製
石制=石製
粗制=粗製
烤制=烤製
醃制=醃製

金質=金製
銀質=銀製
銅質=銅製
鐵質=鐵製
鋼質=鋼製
銥質=銥製
鉛質=鉛製
木質=木製
石質=石製

0金=0G
1金=1G
2金=2G
3金=3G
4金=4G
5金=5G
6金=6G
7金=7G
8金=8G
9金=9G
}金=}G
0 金=0G
1 金=1G
2 金=2G
3 金=3G
4 金=4G
5 金=5G
6 金=6G
7 金=7G
8 金=8G
9 金=9G
} 金=}G
0g=0G
1g=1G
2g=2G
3g=3G
4g=4G
5g=5G
6g=6G
7g=7G
8g=8G
9g=9G
}g=}G
0 g=0G
1 g=1G
2 g=2G
3 g=3G
4 g=4G
5 g=5G
6 g=6G
7 g=7G
8 g=8G
9 g=9G
} g=}G

船型標誌=由巴的象徵
艦型標誌=由巴的象徵
船型符號=由巴的象徵
艦型符號=由巴的象徵
船形標誌=由巴的象徵
艦形標誌=由巴的象徵
船形符號=由巴的象徵
艦形符號=由巴的象徵

維爾維克=薇薇可
橡子=橡實
藍爵=藍調爵士
仙人掌果子=仙人掌果實
冬青樹=冬青
橙子=柳橙
菠蘿=鳳梨
虞美人花=罌粟花
虞美人=罌粟花
土豆=馬鈴薯
齊豆=Qi 之豆
齊瓜=Qi 之瓜
海草=海藻
雪山藥=雪薯
大蔥=青蔥
夏季亮片=夏日閃閃
西紅柿=番茄
野梅=野李
山藥=番薯
藍鐵餅魚=藍七彩神仙魚
大頭魚=鮰魚
岩漿鰻魚=熔岩鰻
虹鱒魚=虹鱒
蠍鯉魚=蠍鯉
幽靈魚=桶眼魚
黃貂魚=魟魚
奶酪=乳酪
蛋黃醬=美乃滋
蜜蜂酒=蜂蜜酒
醃菜=泡菜
果酒=酒
黑莓脆皮餅=脆皮黑莓派
捲心菜沙拉=高麗菜沙拉
海之菜餚=海之盛宴
帕爾瑪奶酪茄子=帕馬森乳酪茄子
琉璃山藥=蜜番薯
魔法糖冰棍=魔法冰糖棒
礦工特供=礦礦糖
煎蛋卷=歐姆蛋
薄煎餅=鬆餅
夏威夷芋泥=芋泥
虞美人籽鬆糕=罌粟籽瑪芬
烤榛子=烤榛果
墨汁義大利餃=異國墨魚餃
塞料麵包=填料
透閃石=水砷鋅礦
黑方石=方鐵錳礦
硅鈣石=矽鈣鉛鋅礦
酸性月岩=淡色月岩
新硅鈣石=新水矽鈣石
五彩碎片=彩虹碎片
黃水晶=黃玉
遠古斑點=挖掘點
精裝旋式魚餌=精裝旋式亮片魚鉤
鼓塊=鼓聲盒
仙塵=精靈塵
長笛塊=笛聲盒
大門=柵欄門
金色椰子=金椰子
金色核桃=金核桃
美食家番茄鹽=美味番茄鹽
能量滋補水=能量補劑
鉛製浮標=鉛浮標
丟失的斧子=遺失的斧頭
遺失之書=遺失的書
美人魚吊墜=美人魚墜飾
怪獸香水=怪物香水
肌肉回復藥=筋力回復劑
鸚鵡螺=鸚鵡螺殼
齊鑽=Qi 之鑽
齊氏調味料=Qi 調味料
兔子的腳=幸運兔腳
虛空幽靈吊墜=虛空幽靈墜飾
木圍欄=木柵欄
木桶火炬=木桶火盆
大綠杖=綠色枴杖糖（大）
大紅杖=紅色枴杖糖（大）
篝火=營火
寶石複製機=晶體複製機
被詛咒的P.K.街機系統=被詛咒的草原之王遊戲機臺
深色牌子=深色告示牌
空置的膠囊=空膠囊
金製火炬=金製火盆
祖父的鐘=爺爺的鐘
綠杖=綠色枴杖糖
重型樹液採集器=大型樹液採集器
祝尼魔賽車街機系統=祝尼魔賽車遊戲機臺
小桶=釀造桶
草坪火烈鳥=草坪紅鶴
大理石火炬=大理石火盆
蛋黃醬機=美乃滋製造機
迷你出貨箱=小型出貨箱
混色杖=混色枴杖糖
產油機=製油機
草原之王街機系統=草原之王遊戲機臺
紅杖=紅色枴杖糖
種子生產器=種子製造機
船標=由巴的象徵
骷髏火炬=骷髏火盆
史萊姆壓蛋器=史萊姆蛋壓製機
劉易斯黃金像=路易斯黃金像
樹樁火炬=樹樁火盆
裝甲=鎧甲
桌子部件L=桌子（左半部）
桌子部件R=桌子（右半部）
-錨-=錨
咀嚼潔齒棒=潔齒棒
銅鍋=銅製淘金盤
魚竿、釣竿=釣竿
阿比蓋爾的占卜寫板=阿比蓋爾的通靈乩板
亞歷克斯的棒球棍=艾力克斯的球棒
黑暗劍=暗黑之劍
艾利歐特的鉛筆=艾略特的鉛筆
森林劍=森林之劍
金色的鐮刀=金鐮刀
海莉的燙髮棒=海莉的電捲棒
哈維的錘子=哈維的神經槌
高級彈弓=大師彈弓
潘妮的煎鍋=佩妮的平底鍋
細劍=護手刺劍
塞巴斯蒂安的遺失之錘=賽巴斯汀的遺失之錘
鋼刀=鋼製彎刀
鋼製輕劍=鋼製小劍
木錘=木槌
藍色軟帽=藍色無邊軟帽
淘盤=銅製淘金盤
雛菊髮卡=雛菊髮夾
護耳=耳罩
軟呢帽=費多拉帽
平頂帽=平頂禮帽
土地神帽=地精帽
金色頭盔=金頭盔
金色面具=黃金面具
老夥計帽=老朋友帽
骨髮夾=骨蝶結
大簷帽=大盤帽
紫紅小帽=紫紅帽
墨西哥帽=寬邊草帽
太陽鏡=太陽眼鏡
三重冕=寶石冠冕
熱帶風小發卡=熱帶風髮夾
西瓜髮卡=西瓜髮箍
白色頭巾=白特本頭巾
牛仔之靴=牛仔靴
蹈火者靴=踏火靴
神怪之鞋=神燈精靈鞋
矮精靈鞋子=矮精靈鞋
太空之靴=太空靴
凍土靴=凍原靴
竊賊戒指=盜賊戒指
大史萊姆=巨型史萊姆
臭蟲=蟲
石碳幽靈=碳幽靈
掘地蟲=挖洞怪
假熔岩菇=假岩漿菇
冰凍史萊姆=冰霜史萊姆
熔岩掘地蟲=岩漿挖洞怪
熔岩火球=岩漿火球
熔岩精靈=岩漿精靈
霸王噴火龍=霸王椒龍
老虎史萊姆=虎紋史萊姆
荒野石魔=荒原魔像
《祖祖城特快列車》=《祖祖城特快車》
封上的窗戶=封閉窗戶
盆景樹=盆景
天花板旗幟=吊旗
深色書架=暗黑書架
風乾太陽花=乾燥向日葵
紅木長椅=桃花心木長椅
金屬窗=金屬窗戶
輪船模型=模型船
新式小茶几=現代小茶几
怪物吊飾=怪物掛飾
拼色地毯=拼布地毯
等離子電視=電漿電視
直立的晶洞=直立水晶洞
火爐=分離式壁爐
冬日餐桌=凜冬餐桌
魚塘=魚池
祝尼魔屋=祝尼魔小屋
聯機小屋=連線小屋
蟲子殺手=蟲蟲剋星
十字軍=聖戰士
省力=輕量化
豐富=富饒
乾草=乾草機器
精通=船長
強力=強化
耐用=節儉
木屑=刨木
黑海鷗=黑鷗
野營灶=野炊爐
暗黑護身符=暗黑護符
黑暗護身符=暗黑護符
姜島=薑之島
潘妮小姐=佩妮老師
特殊動作=特殊技能
卡利科三花蛋=卡利科蛋 
卡利科三花雕像=卡利科雕像 